alias c=cls
alias r=run
alias h=help
alias s=scan
alias a=analyze
alias sa=scan-analyze
alias nuke=run NUKE.exe
alias sa1=scan-analyze 1
alias sa2=scan-analyze 2
alias sa3=scan-analyze 3
alias sa4=scan-analyze 4
alias sa5=scan-analyze 5
alias sa6=scan-analyze 6
alias sa7=scan-analyze 7
alias sa8=scan-analyze 8
alias sa9=scan-analyze 9
alias sa10=scan-analyze 10
alias ssh=run BruteSSH.exe
alias ftp=run FTPCrack.exe
alias http=run HTTPWorm.exe
alias sql=run SQLInject.exe
alias smtp=run relaySMTP.exe
alias cp=scp hack.script
alias rh=run hack.js -t
alias clr=run BruteSSH.exe;run FTPCrack.exe;run HTTPWorm.exe;run SQLInject.exe;run relaySMTP.exe;run NUKE.exe
alias buyall=buy BruteSSH.exe; buy FTPCrack.exe; buy relaySMTP.exe; buy HTTPWorm.exe; buy SQLInject.exe; buy ServerProfiler.exe; buy DeepscanV1.exe; buy DeepscanV2.exe; buy AutoLink.exe;
alias auto=run rhjs.js
alias sc=run serverclear.js
alias f=nano factioninfo.txt
alias dw=connect darkweb
